NO ./textures/eagle.xpm42
SO ./textures/greystone.xpm42
WE ./textures/purplestone.xpm42
EA ./textures/redstone.xpm42

F 124,96,124
C 0,32,32

11111111
10100001
10000101
100N0101
10000001
10001111
11000001
11111111
