NO ./textures/eagle.xpm42
SO ./textures/greystone.xpm42
WE ./textures/purplestone.xpm42
EA ./textures/redstone.xpm42

F 124,96,124
C 0,32,32

11111111111
10000000001
10000S00001
10000000001
10011001001
10110011001
10000000001
11111111111
